7,7,7,7,7,7,7,7,6,6
7,7,7,7,7,7,7,7,7,6
7,7,7,7,7,7,7,7,7,7
2,2,2,2,2,1,7,7,7,7
3,3,3,3,3,1,1,1,1,1
3,3,3,3,3,1,7,7,7,7
4,5,3,3,3,1,7,7,7,7
4,4,5,3,3,1,7,7,7,7
4,4,4,3,3,1,7,7,7,7
4,4,4,5,3,1,7,7,7,7